1 1
**********************
*...*.*..............*
*.***.*....*****.*****
*...*.*.*.*...*......*
***..........**.*.*.**
**********************