1 1
**********************
*...*.*...............
*.***.*....*****.*****
*...*.*.*.*...*......*
***..........**.*.*.**
**********************