11 11
********************
*....**..***........
*.*..*.......*******
*.**...***..**.....*
*.***.*****....*****
***.....*...**.....*
*...**...*.***.*.***
****..**.***.*...***
*****.****.......*.*
...****............*
*.*....*.********..*
*.*.*....*........**
*.*.*.**.*.******..*
*...*......*********
********************