4 4
**********
*.....****
*.***...**
*.***.****
*.**....**
*.**.**.**
*....**..*
***.******
*........*
**********